xxxxxxxxxxxxxxxxxxxxxxxxxxxxxxxxxxxxxxxxxxxxxxxxxxxxxxxxxxxx
------x--------x-----x--------------------------x---------lx
x--xx-x--x--x--x--x--x--x--x--x--x--x--x--x--x--x--x--x--x-x
x--f--x----px-----x--x-----x-----x--------------x-----x----x
xffx--x--x--x--x--x--x--x--x--x--x--x--x--x--x--x--x--x--x-x
x--x-----x--x-----x-----x-----x--------x-----------x-------x
x--x--x--x--x--x--x--x--x--x--x--x--x--x--x--x--x--x--x--x-x
x--x--x--x--x-----x--x--x-----x-----x-----------x--x--x--x-x
x--x--x--x--x--x--x--x--x--x--x--x--x--x--x--x--x--x--x--x-x
x-----x-----x--------x--------------x--x-----x--x--x--x----x
x--x--x--x--x--x--x--x--x--x--x--x--x--x--x--x--x--x--x--x-x
x--x-----x-----x--------x--------x--------x-----x---------px
x--x--x--x--x--x--x--x--x--x--x--x--x--x--x--x--x--x--xffx-x
x-----x--x--x--------x-----------x--------x--x--------x-n-Lx
x--x-px--x--x--x--x--x--x--x--x--x--x--x--x--x--x--x--x--x-x
x-----x-----x-----------x-----x--x--x--------x-----x-------x
x--x--x--x--x--x--x--x-----x--x--x--x--x--x--x--x--x--x--x-x
x--x--x--------x--x--xff---x-----x-----x--x--------------xxx
x--x--x--x--x--x--x--xfpx--x--x--x--x--x--x--x--x--x--x--d-e
xxxxxxxxxxxxxxxxxxxxxxxxxxxxxxxxxxxxxxxxxxxxxxxxxxxxxxxxxxxx